Apple - Pear
Book - Magazine
Car - Truck
Dog - Wolf
Elephant - Hippo
Flower - Weed
Guitar - Violin
House - Apartment
Ice - Snow
Jungle - Forest
Kite - Balloon
Lemon - Lime
Mountain - Hill
Ocean - Sea
Pillow - Cushion
Queen - Princess
River - Lake
Sun - Moon
Train - Tram
Umbrella - Parasol
Banana - Orange
Newspaper - Journal
Motorcycle - Bicycle
Cat - Tiger
Giraffe - Rhino
Rose - Tulip
Piano - Flute
Villa - Cabin
Frost - Hail
Desert - Valley
Parachute - Glider
Grape - Cherry
Volcano - Canyon
River - Creek
Blanket - Duvet
King - Emperor
Pond - Swamp
Star - Comet
Bus - Van
Hat - Cap
Strawberry - Blueberry
Letter - Email
Skateboard - Rollerblades
Bear - Panda
Zebra - Buffalo
Daisy - Orchid
Saxophone - Trumpet
Mansion - Bungalow
Fog - Mist
Meadow - Prairie
Sailboat - Yacht
Watermelon - Pineapple
Cliff - Dune
Stream - Brook
Quilt - Bedspread
Duke - Baron
Harbor - Bay
Planet - Galaxy
Subway - Trolley
Glove - Mitten
Raspberry - Blackberry
Diary - Blog
Scooter - Segway
Lion - Cheetah
Kangaroo - Camel
Lily - Peony
Harp - Cello
Castle - Fortress
Blizzard - Cyclone
Oasis - Island